ক	k
খ	kh
গ	g
ঘ	gh
ঙ	ṅ
চ	c
ছ	ch
জ	j
ঝ	jh
ঞ	ñ
ট	ṭ
ঠ	ṭh
ড	ḍ
ড়	ṛ
ঢ	ḍh
ঢ়	ṛh
ণ	ṇ
ত	t
থ	th
দ	d
ধ	dh
ন	n
প	p
ফ	ph
ব	b
ভ	bh
ম	m
য	y
য়	ẏ
র	r
ৰ	ɹ
ল	l
ৱ	v
শ	ś
ষ	ṣ
স	s
হ	h
ক়	q
খ়	x
গ়	ġ
জ়	z
ফ়	f
র‍্য	rỹ
