ਕ	k
ਖ	kh
ਗ	g
ਘ	gh
ਙ	ṅ
ਚ	c
ਛ	ch
ਜ	j
ਝ	jh
ਞ	ñ
ਟ	ṭ
ਠ	ṭh
ਡ	ḍ
ੜ	ṛ
ਢ	ḍh
ਣ	ṇ
ਤ	t
ਥ	th
ਦ	d
ਧ	dh
ਨ	n
ਪ	p
ਫ	ph
ਬ	b
ਭ	bh
ਮ	m
ਯ	y
ਰ	r
ਲ	l
ਲ਼	ḷ
ਵ	v
ਸ਼	ś
ਸ	s
ਹ	h
ਕ਼	q
ਖ਼	x
ਗ਼	ġ
ਜ਼	z
ਫ਼	f
