क	k
ख	kh
ग	g
घ	gh
ङ	ṅ
च	c
छ	ch
ज	j
झ	jh
ञ	ñ
ट	ṭ
ठ	ṭh
ड	ḍ
ड़	ṛ
ढ	ḍh
ढ़	ṛh
ण	ṇ
त	t
थ	th
द	d
ध	dh
न	n
प	p
फ	ph
ब	b
भ	bh
म	m
ऩ	ṉ
ऴ	ḻ
य	y
य़	ẏ
र	r
ऱ	r̆
ल	l
ळ	ḷ
व	v
श	ś
ष	ṣ
स	s
ह	h
क़	q
ख़	x
ग़	ġ
ज़	z
फ़	f
