ક	k
ખ	kh
ગ	g
ઘ	gh
ઙ	ṅ
ચ	c
છ	ch
જ	j
ઝ	jh
ઞ	ñ
ટ	ṭ
ઠ	ṭh
ડ	ḍ
ઢ	ḍh
ણ	ṇ
ત	t
થ	th
દ	d
ધ	dh
ન	n
પ	p
ફ	ph
બ	b
ભ	bh
મ	m
ય	y
ર	r
લ	l
ળ	ḷ
વ	v
શ	ś
ષ	ṣ
સ	s
હ	h
ક઼	q
ખ઼	x
ગ઼	ġ
જ઼	z
ફ઼	f
