ක	k
ඛ	kh
ග	g
ඝ	gh
ඞ	ṅ
ඟ	n̆g
ච	c
ඡ	ch
ජ	j
ඣ	jh
ඤ	ñ
ඦ	n̆j
ට	ṭ
ඨ	ṭh
ඩ	ḍ
ඪ	ḍh
ණ	ṇ
ඬ	n̆ḍ
ත	t
ථ	th
ද	d
ධ	dh
න	n
ඳ	n̆d
ප	p
ඵ	ph
බ	b
භ	bh
ම	m
ඹ	m̆b
ය	y
ර	r
ල	l
ළ	ḷ
ව	v
ශ	ś
ෂ	ṣ
ස	s
හ	h
ෆ	f
ඥ	ᵑǰ
