କ	k
ଖ	kh
ଗ	g
ଘ	gh
ଙ	ṅ
ଚ	c
ଛ	ch
ଜ	j
ଝ	jh
ଞ	ñ
ଟ	ṭ
ଠ	ṭh
ଡ	ḍ
ଡ଼	ṛ
ଢ	ḍh
ଢ଼	ṛh
ଣ	ṇ
ତ	t
ଥ	th
ଦ	d
ଧ	dh
ନ	n
ପ	p
ଫ	ph
ବ	b
ଭ	bh
ମ	m
ଯ	y
ୟ	ẏ
ର	r
ଲ	l
ଳ	ḷ
ଵ	v
ୱ	w
ଶ	ś
ଷ	ṣ
ସ	s
ହ	h
