ಕ	k
ಖ	kh
ಗ	g
ಘ	gh
ಙ	ṅ
ಚ	c
ಛ	ch
ಜ	j
ಝ	jh
ಞ	ñ
ಟ	ṭ
ಠ	ṭh
ಡ	ḍ
ಢ	ḍh
ಣ	ṇ
ತ	t
ಥ	th
ದ	d
ಧ	dh
ನ	n
ಪ	p
ಫ	ph
ಬ	b
ಭ	bh
ಮ	m
ಱ	ṟ
ೞ	ḻ
ಯ	y
ರ	r
ಲ	l
ಳ	ḷ
ವ	v
ಶ	ś
ಷ	ṣ
ಸ	s
ಹ	h
ಜ಼	z
ಫ಼	f
ರ‍್ಯ	rỹ
