క	k
ఖ	kh
గ	g
ఘ	gh
ఙ	ṅ
చ	c
ౘ	ĉ
ఛ	ch
జ	j
ఝ	jh
ఞ	ñ
ట	ṭ
ఠ	ṭh
డ	ḍ
ఢ	ḍh
ణ	ṇ
త	t
థ	th
ద	d
ధ	dh
న	n
ప	p
ఫ	ph
బ	b
భ	bh
మ	m
ఱ	ṟ
ఴ	ḻ
య	y
ర	r
ల	l
ళ	ḷ
వ	v
శ	ś
ష	ṣ
స	s
హ	h
ౙ	z
