ക	k
ഖ	kh
ഗ	g
ഘ	gh
ങ	ṅ
ച	c
ഛ	ch
ജ	j
ഝ	jh
ഞ	ñ
ട	ṭ
ഠ	ṭh
ഡ	ḍ
ഢ	ḍh
ണ	ṇ
ത	t
ഥ	th
ദ	d
ധ	dh
ന	n
പ	p
ഫ	ph
ബ	b
ഭ	bh
മ	m
റ	ṟ
ഺ	ṯ
ഩ	ṉ
ഴ	ḻ
യ	y
ര	r
ല	l
ള	ḷ
വ	v
ശ	ś
ഷ	ṣ
സ	s
ഹ	h
