aa	ā
ii	ī
uu	ū

zh	ḻ
sh	ṣ
ch	c

E	ē
O	ō
H	ḥ

T	ṭ
D	ḍ
N	ṇⸯ
n	nⸯ
m	ṁ
r	rⸯ
l	lⸯ
S	ś
L	ḷⸯ
t	ṟṟ
R	r̥

r̥r̥	r̥̄
nⸯj	ñ
ṟṟh	t
nⸯg	ṅ

rⸯrⸯ	ṟ
nⸯnⸯ	nn
nⸯd	nd
nⸯṁ	nm
ṇⸯṇⸯ	ṇṇ
ṇⸯḍ	ṇḍ
ṇⸯṭ	ṇṭ
ṇⸯṁ	ṇm
lⸯlⸯ	ll
lⸯṁ	lm
lⸯp	lp
ḷⸯḷⸯ	ḷḷ

ⸯa	a
ⸯā	ā
ⸯi	i
ⸯī	ī
ⸯu	u
ⸯū	ū
ⸯr̥	r̥
ⸯe	e
ⸯē	ē
ⸯo	o
ⸯō	ō
ⸯy	y
ⸯr	r
ⸯl	l
ⸯv	v

ṁṁ	mm
ṁa	ma
ṁā	mā
ṁi	mi
ṁī	mī
ṁu	mu
ṁū	mū
ṁe	me
ṁē	mē
ṁo	mo
ṁp	mp
ṁy	my
ṁl	ml
ṁv	mv
ṁr	mr
ṁr̥	mr̥

nⸯt	nt
nⸯṟṟ	nⸯ̆ṟ
'~	
~	
